######################################
#                                    #
#                                    #
#                                    #
#                                    #
#									 #
#				                     #
#		LP	P  M II   P I  LL I PM L M  P  ML  MI   #
######################################
