######################################
#                                    #
#                                    #
#                                    #
#                                    #
#				                     #
#  				                     #
#		E		  P      E		     #
######################################
