######################################
#                                    #
#                                    #
#                                    #
#                                    #
#				                     #
#  				                     #
#	E	P E M P E	I  P M  M PE 	II	M  M PE    E #
######################################
