######################################
#                                    #
#                                    #
#                                    #
#                                    #
#									 #
#				                     #
#				I             M				 #
######################################
