######################################
#                                    #
#                                    #
#                                    #
#                                    #
#									 #
#				                     #
#  M L II L P L I I I L P L M P I L M  P M P M P M  #
######################################
